##!..#..#.+..
#...##.<..#?.
.$$$.........
k...##@.&####
#...>....#...
##..#...##...
...$....i####
..###########