##+..#..#..
#...##....#
.......$..
@...##.....
#........#.
##..#..+##.
