-1, -1, 8, 7, 0, -1, 4, 3, -1, 0, 0, 0
-1, 8, 7, 6, -1, -1, 3, 2, 0, 0, -1, 0
8, 7, 6, 5, 4, 3, 2, 1, 0, 0, 0, 0 
0, 0, 0, 0, -1, -1, 1, 0, 0, -1, -1, -1
-1, 0, 0, 0, 0, 0, 0, 0, 0, -1, 0, 0
-1, -1, 0, 0, -1, 0, 0, 0, -1, -1, 0, 0
0, 0, 0, 0, 0, 0, 0, 0, 0, -1, -1, -1