##...#..#..
#...##....#
..........
@...##.....
#........#.
##..#...##.
