##!..#..#.+..
#...##.<..#?.
.$$$.........
k...##@.&####
#...>...=#...
##..#...##...
...$....i####
..###########