##...#..#..
#...##....#
..........
....##@.&..
#........#.
##..#...##.
