###############
###!..#..#.+..#
##...##.<..#?.#
#.$$$.........#
#k1..##@.2#####
##...>...=#...#
###..#...##...#
#...$....i#####
#..############
###############