###############
#!..#k.+..#...#
#.............#
##.@..###<...##
#$....###....$#
#$.....>.....$#
##....###....##
#......=......#
#...#..+.i#..?#
###############