###############
#+..?.$##k....#
#.=....##.....#
#......##....$#
###..@.....>###
###<........###
#i....##......#
#.....##...=..#
#....$##!....+#
###############