###############
#.....$k.....+#
#.###########.#
#..>.......<..#
#..#...@...#..#
#......#......#
#....!###?.=..#
#.###########.#
#+..i..$$.....#
###############