###############
###...#..#.+..#
##...##....#..#
#.........&&..#
#....##@.&....#
##........#...#
###..#...##...#
#...$.....#####
#..############
###############