###############
###!..#..#.+..#
##...##.<..#?.#
#.$$$.........#
#k...##@.1#####
##...>...=#...#
###..#.1.##...#
#...$....i#####
#..############
###############