###############
#.....$k.....+#
#.###########.#
#..>...2...<..#
#..#...@...#..#
#......#......#
#....!###?.=..#
#.###########.#
#+..i.2$$/....#
###############