##...#..#.+..
#...##....#..
.............
....##@.&....
#........#...
##..#...##...
...$.....####
..###########