##...#..#.+..
#...##....#..
.$$$.........
....##@.&####
#........#...
##..#...##...
...$.....####
..###########