###############
#!..#k.+..#...#
#.......1.....#
##.@..###<...##
#$....###....$#
#$.....>..2..$#
##....###....##
#......=......#
#...#.1+.i#..?#
###############