###############
###!..#..#.+..#
##...##.<..#?.#
#.$$$.........#
#k...##@.1#####
##...>...=#...#
###..#...##...#
#...$.2..i#####
#..############
###############